1      1      1      1      1      1      1      1      1      1      1       1      1      1      1      1
1      0      0      0      0      0      0      0      0      0      0       0      0      0      313,3  1
1      1      1      1      1      1      1      1      1      1      1       1      1      1      0      1
1      0      0      0      0      0      0      1      0      0      0       34,3   0      0      1      1
1      0      0      0      1      1      0      1      0      0      0       1      1      0      1      1
1      0      0      0      1      1      0      1      0      0      0       1      0      1      0      1
1      1      1      1      1      31,7   0      1      1      1      1       0      0      0      0      1
1      0      0      0      1      0      1      0      0      0      0       0      0      0      0      1
1      0      1      0      0      1      0      0      0      0      0       0      0      0      0      1
1      1      0      0      0      0      0      0      0      0      0       0      0      0      0      1
1      0      0      0      0      0      0      0      0      0      0       0      0      0      0      1
1      0      0      0      0      0      0      0      0      0      0       0      0      0      0      1
1      0      0      0      0      0      0      0      0      0      0       0      0      0      0      1
1      0      0      0      0      0      0      0      0      0      0       0      0      0      0      1
1      0      0      0      0      0      0      0      0      0      0       0      0      0      0      1
1      0      0      0      0      0      0      0      0      0      0       0      0      0      0      1
1      0      0      0      0      0      0      0      0      0      0       0      0      0      0      1
1      0      0      0      0      0      0      0      0      0      0       0      0      0      0      1
1      0      0      0      0      0      0      0      0      0      0       0      0      0      0      1
1      0      0      0      0      0      0      0      0      0      0       0      0      0      0      1
1      1      1      1      1      1      1      1      1      1      1       1      1      1      1      1