1 1 1 1 1 1 1 1 1 1 1
1 2 0 0 0 0 0 0 0 32,3 1
1 1 1 1 1 1 1 1 1 0 1
1 0 0 1 0 0 0 0 0 1 1
1 1 0 1 0 1 0 1 0 0 1
1 0 0 1 0 1 1 1 1 0 1
1 0 1 0 0 0 0 38,10 1 0 1
1 0 0 0 1 1 1 0 1 0 1
1 0 1 0 0 0 0 1 0 32,10 1
1 1 0 1 1 1 1 1 1 1 1
1 0 0 0 1 0 1 0 0 1 1
1 0 1 1 1 1 0 1 0 4 1
1 0 0 0 0 0 32,5 1 0 1 1
1 1 1 1 1 1 1 1 1 1 1