1 1     1 1 1 1 1 1 1 1
1 0     0 0 0 0 0 0 1 1
1 0     1 0 0 0 0 0 0 1
8 35,10 7 0 0 0 0 0 2 8
1 0     1 0 0 0 0 0 0 1
1 0     0 0 0 0 0 0 0 1
1 1     1 0 0 0 0 0 0 1
1 1     1 1 1 1 1 7 0 1
1 1     1 0 1 0 0 0 0 1
1 0     0 1 1 0 1 0 0 1
1 0     0 1 8 0 7 0 0 1
1 0     0 1 1 0 1 0 0 1
1 0     0 0 1 0 0 0 0 1
1 1     1 1 1 1 1 1 1 1