1 1 1 1 1 1 1 1 1 1 1 1 1 1 1 1 1 7 1 1
1 0 0 0 0 0 1 1 0 0 0 7 5 0 0 1 0 0 0 1
1 0 1 0 1 0 0 1 31,2 1 0 1 1 0 0 6 0 0 2 8
1 1 1 0 1 1 0 1 1 1 0 0 6 0 0 1 0 0 0 1
1 0 0 0 0 0 0 0 1 1 1 1 1 1 1 1 1 7 1 1
1 0 1 1 1 0 1 0 1 7 35,19 0 0 0 0 0 0 0 5 1
1 0 0 4 0 0 1 0 0 1 35,20 0 0 0 0 0 0 0 8 1
1 1 1 0 1 1 1 1 0 1 1 1 1 1 1 0 0 7 1 1
1 0 1 0 0 0 0 0 0 0 0 1 1 0 0 0 0 0 0 1
1 0 0 0 1 1 0 1 1 1 0 1 8 0 0 0 0 0 0 8
1 1 0 1 0 0 0 1 0 1 0 1 7 0 0 0 0 0 0 7
1 0 0 1 0 1 0 0 0 0 0 1 5 0 0 0 0 0 0 8
1 0 1 1 0 1 0 1 1 6 1 1 7 0 0 0 0 0 0 7
1 0 0 0 0 0 0 1 0 32,20 0 1 8 0 0 0 0 0 0 8
1 1 0 1 1 0 1 1 0 0 0 1 7 0 0 0 0 0 0 7
1 0 0 1 0 0 0 1 0 0 0 1 8 0 0 0 0 0 0 8
1 1 1 0 1 1 1 1 1 1 1 1 7 0 0 0 0 0 0 7
1 0 1 0 0 0 0 0 0 0 0 0 6 0 0 0 0 0 0 8
1 0 0 0 1 1 1 1 1 1 1 1 7 1 1 1 1 1 1 1 1
1 1 6 1 7 0 0 0 0 0 0 0 0 6 0 0 0 0 0 0 1
1 0 0 0 1 0 0 0 0 0 0 0 0 8 1 0 0 0 0 0 1
1 0 0 0 1 1 1 1 1 1 0 0 7 1 1 0 0 0 0 0 1
1 0 0 0 1 0 0 0 0 8 0 0 0 0 1 0 0 0 0 0 1
1 1 1 1 1 0 1 1 0 1 0 0 0 0 1 0 1 0 1 0 1
1 0 0 0 1 0 1 0 0 1 8 1 8 1 1 5 1 6 1 5 1
1 6 1 0 0 0 1 0 1 1 1 1 1 1 7 1 1 0 1 1 1
1 0 1 1 1 0 1 0 1 0 1 0 0 0 0 0 1 0 0 33,27 1
1 0 0 0 1 0 1 0 1 0 0 0 1 0 0 0 1 1 1 0 1
1 1 1 0 1 0 0 0 1 1 1 1 1 0 1 0 1 0 0 1 1
1 39,26 1 1 1 0 1 1 1 1 1 1 1 5 1 6 1 0 0 1
1 0 0 0 0 0 1 0 0 0 0 0 0 0 1 0 1 1 1 1
1 1 1 1 1 1 1 0 0 0 0 0 0 0 0 0 1 0 0 7
1 0 0 0 0 0 1 1 6 1 5 1 5 1 1 1 7 0 0 7
1 0 1 0 0 0 0 1 0 1 0 1 0 1 0 0 5 0 0 7
1 0 1 1 1 1 0 1 0 0 0 0 0 1 0 1 7 0 0 7
1 6 1 5 1 1 318,45 1 0 0 0 0 0 1 0 1 1 0 0 7
1 0 0 0 1 1 0 1 5 1 5 1 6 1 5 1 1 1 1 1
1 0 0 0 1 0 0 1 0 1 0 1 0 1 0 1 1 1 0 1
1 0 1 0 1 1 0 1 0 0 0 0 0 1 0 0 5 1 0 1
1 0 1 0 1 1 1 1 0 0 0 0 0 1 0 1 0 1 0 1
1 5 1 6 1 5 1 1 5 1 5 1 5 1 5 1 0 1 0 1
1 0 0 0 0 0 0 1 0 1 0 1 0 1 7 1 0 1 0 1
1 0 0 0 0 0 1 1 0 1 0 1 0 1 1 1 5 1 1 1
1 0 0 0 0 0 0 0 0 0 0 1 0 5 0 0 0 1 0 1
1 1 1 1 1 1 1 1 1 1 1 1 1 1 1 1 1 1 0 1
1 1 1 7 1 7 1 7 1 7 1 7 1 1 1 1 1 1 0 1
1 7 4 4 4 4 4 4 4 4 4 4 7 0 0 0 0 1 0 1
8 4 4 4 4 4 4 4 4 4 4 310,52 6 0 0 0 0 0 0 1
1 7 4 4 4 4 4 4 4 4 4 4 7 0 0 0 0 1 0 1
1 1 1 7 1 7 1 7 1 7 1 7 1 1 1 1 1 1 1 1
1 1 1 7 1 7 1 7 1 7 1 7 1 1 1 1 1 1 1 1
1 7 4 4 4 4 4 4 4 4 4 4 7 1
8 4 4 4 4 4 4 4 4 4 4 4 8 1
1 7 4 4 4 4 4 4 4 4 4 4 7 1
1 1 1 7 1 7 1 7 1 7 1 7 1 1

