11111
10021
10001
10001
11111
