1 1    1 1 1 1 1 1 1 1 1
1 37,5 0 0 0 0 0 0 0 0 1
1 1    1 0 0 0 0 0 0 0 1
1 38,3 0 0 0 0 0 0 2 0 1
1 1    1 0 0 0 0 1 1 0 1
1 38,1 0 0 0 0 1 0 0 0 1
1 1    1 1 1 1 1 1 1 1 1
