1 1 1 1 1 1 1 1 1 1 1
1 0 0 0 0 0 0 0 0 0 1
1 1 1 0 0 0 0 0 0 0 1
8 35,10 0 0 0 0 0 0 2 0 8
1 1 1 0 0 0 0 0 0 0 1
1 0 0 0 0 0 0 0 0 0 1
1 1 1 1 1 0 0 1 1 1 1
1 1 1 1 1 0 0 1 1 1 1
1 0 0 0 0 0 0 0 0 0 1
1 1 1 0 0 0 0 0 0 0 1
7 38,3 0 0 0 0 0 0 0 0 7
1 1 1 0 0 0 0 0 0 0 1
1 0 0 0 0 0 0 0 0 0 1
1 1 1 1 1 1 1 1 1 1 1
