1 1 1 1 1 1 1 1 1 1 1
1 32,5 0 0 0 0 0 0 0 0 1
1 1 1 0 0 0 0 0 0 0 1
1 32,3 0 0 0 0 0 38,3 2 0 1
1 1 1 0 0 0 0 0 0 0 1
1 32,1 0 0 0 0 0 0 0 0 1
1 1 1 1 1 1 1 1 1 1 1
