1      1      1      1      1      1      1      1      1      1      1      1      1      1      1      1      1      1      1
1      0      1      0      1      0      1      0      1      0      1      0      1      0      1      0      1      0      1
1      0      1      0      1      0      1      0      1      0      1      0      1      0      1      0      1      0      1
1      0      1      0      1      0      1      0      1      0      1      0      1      0      1      0      1      0      1
1      0      1      0      1      0      1      0      1      0      1      0      1      0      1      0      1      0      1
1      0      1      0      1      0      1      0      1      0      1      0      1      0      1      0      1      0      1
1      0      1      0      1      0      1      0      1      0      1      0      1      0      1      0      1      0      1
1      0      1      0      1      0      1      0      1      0      1      0      1      0      1      0      1      0      1
1      0      1      0      1      0      1      0      1      0      1      0      1      0      1      0      1      0      1
1      0      1      0      1      0      1      0      1      0      1      0      1      0      1      0      1      0      1
1      0      1      0      1      0      1      0      1      0      1      0      1      0      1      0      1      0      1
1      0      1      0      1      0      1      0      1      0      1      0      1      0      1      0      1      0      1
1      0      1      0      1      0      1      0      1      0      1      0      1      0      1      0      1      0      1
1      0      1      0      1      0      1      0      1      0      1      0      1      0      1      0      1      0      1
1      0      1      0      1      0      1      0      1      0      1      0      1      0      1      0      1      0      1
1      33,1      1      0      1      0      1      0      1      0      1      0      1      0      1      0      1      0      1
1      1      1      0      1      0      1      0      1      0      1      0      1      0      1      0      1      0      1
1      1      1      35,1      1      0      1      0      1      0      1      0      1      0      1      0      1      0      1
1      1      1      1      1      0      1      0      1      0      1      0      1      0      1      0      1      0      1
1      1      1      1      1      37,1      1      0      1      0      1      0      1      0      1      0      1      0      1
1      1      1      1      1      1      1      0      1      0      1      0      1      0      1      0      1      0      1
1      1      1      1      1      1      1      39,1      1      0      1      0      1      0      1      0      1      0      1
1      1      1      1      1      1      1      1      1      0      1      0      1      0      1      0      1      0      1
1      1      1      1      1      1      1      1      1      311,1      1      0      1      0      1      0      1      0      1
1      1      0      1      1      1      1      1      1      1      1      0      1      0      1      0      1      0      1
1      0      0      0      1      1      1      1      1      1      1      313,1      1      0      1      0      1      0      1
1      1      0      1      1      1      1      1      1      1      1      1      1      0      1      0      1      0      1
1      1      1      1      1      1      1      1      1      1      1      1      1      315,1      1      0      1      0      1
1      1      1      1      1      1      1      1      1      1      1      1      1      1      1      0      1      0      1
1      1      1      1      1      1      1      1      1      1      1      1      1      1      1      317,1      1      0      1
1      1      1      1      1      1      1      1      1      1      1      1      1      32,26      1      1      1      0      1
1      1      1      1      1      1      1      1      1      1      1      1      1      0      0      0      0      0      1
1      1      1      1      1      1      1      1      1      1      1      1      1      1      1      1      1      1      1